   ##########################################################
         #           #           #        #                 #
#  #  #  #  #  ####  #######  #######  ##########  ##########
#  #  #     #     #  #     #  #                 #  #  #     #
#######  ####  ####  ####  #  #  #  ####  #######  #  #  #  #
#  #  #     #  #        #        #  #  #     #           #  #
#  #  #############  ####  ##########  ####  #  ####  #######
#     #  #     #     #        #     #  #  #        #        #
####  #  ####  #  ##########  #  ####  #  #  #  ####  ####  #
#     #  #     #     #  #              #     #  #        #  #
#  ####  #  #######  #  #######  #######  ###################
#        #           #     #  #     #        #  #        #  #
#######  #######  #  #  ####  ####  ##########  ####  ####  #
#  #              #  #  #     #  #     #  #     #  #     #  #
#  ####  ####  ####  #  ####  #  #  ####  ####  #  ####  #  #
#     #  #  #  #     #  #  #  #  #  #     #  #           #  #
#  #  ####  ####  ####  #  #  #  #  #  ####  #  ##########  #
#  #  #        #  #     #                       #  #        #
#  ####  ####  #  ####  #  #  ####  #  ####  ####  #  #  #  #
#     #  #  #  #           #     #  #  #     #  #     #  #  #
#  ####  #  #######  ####  ####  ####  ####  #  ####  ####  #
#  #                 #  #     #     #  #  #        #  #     #
#  #  ##########  #  #  ################  #  #  ####  ####  #
#     #           #  #     #              #  #           #  #
#  #  ####  #############  #  #  ####  ####  #  #############
#  #     #     #  #  #        #  #     #  #  #  #     #     #
#  ####  #  ####  #  #  #  #######  ####  #  #  ####  #  ####
#     #  #     #        #  #  #  #     #     #  #        #  #
####  #  #  ####  #  #  #  #  #  #  ####  ####  #  #######  #
#     #  #  #     #  #  #  #           #  #        #        #
#  ###################  #######  #  #  ####  ####  #######  #
#        #        #     #        #  #        #        #     #
#  ####  ####  #  ####  ####  #  #  #  #  ####  ####  ####  #
#     #     #  #           #  #  #  #  #  #  #  #           #
################  ####  #############  ####  #  ####  ####  #
#     #        #  #        #  #  #  #  #  #  #  #     #     #
#  #  #######  #  ####  ####  #  #  ####  #  #######  ####  #
#  #           #     #        #     #        #  #     #     #
#  ##########  #  ####  #  #  ####  #  #  ####  #  ####  #  #
#  #              #     #  #  #        #           #     #  
##########################################################  
