   #########################################################################
      #                 #  #  #     #              #        #        #     #
####  #######  ####  ####  #  ####  ####  #  #  ####  ####  #  ####  #  ####
#                 #                    #  #  #     #  #        #  #  #  #  #
#  #######  #  #############  ##########  ####  #  ##########  #  ####  #  #
#  #        #        #  #  #  #  #     #  #     #     #        #  #  #     #
#  #######  ##########  #  #  #  ####  #  ####  #############  #  #  ####  #
#        #        #  #  #     #  #        #     #           #  #  #        #
#######  ##########  #  #  ####  #######  #  #######  ####  #  #  ####  ####
#  #     #        #     #                 #              #  #           #  #
#  #  #######  ####  #############  ####  #  ##########  #  #  ####  #  #  #
#  #  #           #  #        #        #  #  #  #  #  #  #        #  #  #  #
#  #  ####  #######  #######  #  #  ####  ####  #  #  ################  #  #
#     #  #  #  #  #              #     #     #     #           #           #
#  ####  #  #  #  #  #  #  #############  #######  ####  #############  #  #
#        #  #  #     #  #           #        #              #  #  #     #  #
#  #######  #  ##########  #  ############################  #  #  #  ####  #
#  #           #     #  #  #        #  #  #  #        #        #     #     #
#  ####  #  ####  ####  #  #  #  ####  #  #  ####  #  #  #  ################
#     #  #     #     #     #  #  #     #           #  #  #        #        #
####  ####  #  ####  #  ####  #  #  ####  #  #######  #######  ####  ####  #
#     #  #  #     #  #     #  #        #  #  #  #  #     #        #  #     #
#  ####  ####  ####  ####  ###################  #  #  #  #######  #  #  ####
#                    #     #           #           #  #     #  #     #  #  #
####  ##########  #######  #  ####  #  #  #  ####  #  ####  #  #  ####  #  #
#     #           #  #     #     #  #  #  #     #     #  #  #        #     #
#  ##########  ####  ####  #  ####  #######  #  #######  #  #  #  ####  ####
#        #              #        #  #        #  #              #     #  #  #
#######  ####  #############  #  ####  ####  ####  ####  #  #############  #
#           #     #  #  #  #  #  #  #  #  #  #  #     #  #     #        #  #
#######  ####  #  #  #  #  #  #  #  #  #  ####  ####  ####  #  #  #######  #
#     #  #     #     #        #  #        #     #     #  #  #        #     #
#  ######################  #  #############  ####  ####  #######  #######  #
#  #  #     #     #        #  #     #                 #  #     #           #
#  #  ####  #  ####  #  ####  #  ####  #######  #######  #  ##########  #  #
#           #  #     #  #           #     #  #                 #        #  #
#######  ####  #  #######  #  #######  #  #  ####  ####  #  ##########  ####
#  #           #        #  #        #  #     #        #  #     #           #
#  ####  #  #######  #  #  #  #  #############  ####  #######  #  #######  #
#  #     #  #  #     #  #  #  #     #        #     #     #     #  #        #
#  ####  #  #  #  #  ###################  #  ####  #  ################  #  #
#        #  #  #  #  #     #     #     #  #        #     #     #  #  #  #  #
#  #######  #  #  #######  #  #  #  ####  #  ####  ####  ####  #  #  ####  #
#  #  #     #  #     #        #     #     #     #  #     #           #     #
#  #  #######  #  #######  #  #  ####  ####  ##########  ####  #  #######  #
#                 #        #  #           #     #     #        #        #  #
#  ##########  ####  #  ################  #######  #  ####  ##########  ####
#     #           #  #     #  #                 #  #  #  #  #     #  #     #
#######  ####  #  #  #  ####  #  #  #######  #######  #  #  ####  #  #  #  #
#        #     #     #  #        #  #           #                    #  #  
#########################################################################  
