   ########################################################################################
                        #  #              #  #        #        #              #           #
####  #######  #######  #  #  #  #######  #  #  #  #  ####  ####  ####  ####  #  #  #######
#     #     #     #  #  #  #  #        #  #     #  #        #     #  #     #  #  #        #
#  ####  ##########  #  #  #  #######  #######  #  ##########  ####  ################  ####
#  #  #  #  #  #     #  #           #  #  #  #  #     #              #           #  #     #
#  #  #  #  #  ####  #  #  #############  #  #######  #  #  ####  ####  ##########  #  ####
#              #                 #     #     #     #  #  #     #  #  #        #     #  #  #
#  ####  #  #  ###################  #  ####  ####  #  ####  #######  #  #  ####  #  #  #  #
#     #  #  #     #        #  #     #                 #     #  #        #  #  #  #        #
#  ####  #############  ####  #  ####  ####  #  #######  #  #  #  #######  #  #  #  #######
#     #     #              #     #  #     #  #     #     #  #  #  #              #     #  #
####  #  #  #  ####  #############  #  #######  #  #  #  ####  #  ###################  #  #
#     #  #        #           #           #  #  #  #  #  #     #        #  #  #           #
#  ##########  ####  ######################  #  #######  ####  #######  #  #  ####  ####  #
#        #  #  #     #     #     #  #           #  #                    #           #  #  #
#  #  ####  #  #######  #  #  #  #  ####  #######  #  ####  #  #  ####  #  #  #######  #  #
#  #        #        #  #     #                       #     #  #  #     #  #  #           #
##########  #  #  ####  ####  #######  #  #######  #  #  #######  ################  #######
#  #     #  #  #     #  #     #  #  #  #  #  #     #  #        #  #        #     #        #
#  #  #  #######  #############  #  #  ####  #  #  ####  #  #  ####  #  ####  #######  ####
#     #        #              #        #        #  #     #  #     #  #  #  #              #
#  #  #  ####  #  ################  #  ##########  #######  ##########  #  ####  ####  ####
#  #  #  #  #  #     #  #  #        #     #  #        #  #  #  #        #  #  #  #  #     #
####  #  #  #  ####  #  #  #  ##########  #  ##########  ####  #  #######  #  #  #  #######
#  #  #  #     #     #           #        #              #  #     #           #  #        #
#  #  ##########  #  #  ##########  #############  #######  #  ####  #  ################  #
#     #  #        #  #  #  #        #  #     #  #        #           #        #     #  #  #
#  #  #  #######  ####  #  ##########  ####  #  #######  #  ####  #  ####  #  ####  #  #  #
#  #  #  #           #  #     #  #     #           #  #        #  #     #  #  #           #
####  #  #  #  ####  #  #  ####  #  ####  #  #  ####  #######  #############  #######  ####
#     #     #  #                 #        #  #        #        #  #     #        #        #
####  #  #  ####  ####  ##########  #  #  #######  #######  ####  #  ####  ####  #  #######
#  #  #  #  #     #     #  #        #  #  #  #     #  #        #  #     #  #     #     #  #
#  #  #  ####  #  ####  #  #  #  #  #  ####  #  ####  #  #  #  #  #  #  #  #  #  ####  #  #
#           #  #  #     #     #  #  #     #              #  #  #     #  #  #  #  #        #
##########  #######  #  ####  ####  #  #############  ####  ##########  ####  ####  ####  #
#           #        #  #        #  #     #        #  #  #     #                 #  #     #
####  #  #############  #  ##########  #  #  ##########  #######  ####  #  #  #  #  #######
#     #        #           #     #     #  #     #           #     #  #  #  #  #  #        #
#######  ###################  ####  #  ####  ####  ####  #  #######  ####  ####  #######  #
#     #     #     #  #     #     #  #     #     #  #  #  #     #              #     #     #
####  ####  ####  #  #  #  ####  #  ##########  #  #  ####  #############  #############  #
#     #  #              #     #  #  #              #     #     #     #  #     #  #     #  #
#  ####  #  ##########  #######  ################  #  #  #  ####  ####  #  ####  #  ####  #
#        #  #                 #  #     #        #  #  #                             #  #  #
#######  #  ##########  ####  #  #  #######  ##########  #  ####  #  ##########  #  #  #  #
#  #  #           #     #  #                 #           #  #  #  #        #  #  #  #  #  #
#  #  #  #######  #  #  #  #  #  #  #  #############  #######  ####  #  ####  ####  #  #  #
#  #        #     #  #  #  #  #  #  #  #  #     #  #        #     #  #  #        #        #
#  #  #############  ####  #######  ####  ####  #  #############  ####  #  #######  #  ####
#     #        #        #        #     #        #     #     #     #     #           #     #
#######  #######  #######  ##########  ####  #######  ####  ####  #  #  ####  ##########  #
#        #           #  #  #     #  #  #           #  #  #        #  #  #  #  #     #     #
####  #  #  ####  ####  #  ####  #  #  #  ####  #  #  #  ####  #######  #  #  #  #  #  #  #
#     #     #  #     #     #              #     #        #  #  #  #     #     #  #  #  #  #
####  ####  #  #  ####  #############  #  #############  #  #  #  ####  #  ####  #######  #
#  #  #     #  #  #                    #           #              #     #     #           #
#  #  #  #  #  ####  ####  #  ####  #######  ##########  #  #############  ####  #  #######
#     #  #  #           #  #     #     #        #        #  #              #     #        
########################################################################################  
