   ########################################################################################
      #     #  #                       #              #        #  #     #  #              #
#  #  #  #  #  #  #  #  ####  ####  #  ####  #  ####  #  #  #  #  #  ####  ####  ##########
#  #     #        #  #     #     #  #        #  #  #  #  #  #     #        #  #  #        #
#######  #  #  ####  #  #######  #######  #######  #######  #############  #  #  ####  ####
#        #  #     #  #  #  #  #  #  #  #  #     #     #  #  #  #  #           #     #     #
#  #######  #######  ####  #  #  #  #  ####  #  ####  #  #  #  #  #######  ####  ####  #  #
#     #     #           #     #  #     #     #  #        #           #              #  #  #
#######  #  #  #  #  ####  #######  ####  #  #  #  ##########  #  ####  #############  #  #
#        #  #  #  #     #     #  #  #  #  #  #        #        #  #  #     #     #  #  #  #
##########  ####  #  #  #  ####  #  #  #  #######  ####  #  #######  #  ####  #  #  ####  #
#  #     #     #  #  #           #  #  #  #     #        #     #     #  #     #  #        #
#  ####  #############  #  ####  #  #  ####  ####  ####  #######  #  #  #######  #######  #
#  #     #  #  #     #  #  #           #  #  #  #     #  #  #     #     #     #  #  #     #
#  ####  #  #  #  ####  #  #  ####  ####  #  #  #  #  ####  ####  ####  #  #  #  #  ####  #
#     #                 #  #     #     #           #  #     #  #     #     #     #        #
#  #  ####  #  #  #############  #############  #######  #  #  #######  ##########  ####  #
#  #     #  #  #  #     #  #        #              #  #  #        #           #     #     #
#  ####  #  #######  #  #  ####  #  #######  ####  #  #######  #######  ####  #  ####  ####
#  #        #     #  #     #  #  #  #        #           #           #     #  #  #        #
#######  #  #  ####  ####  #  #############  #  #######  #  #######  #  #######  #  #  ####
#        #  #  #        #                    #     #     #  #  #           #     #  #     #
#  #  ####  #  ####  ####  ####  #  ####  ####  #######  ####  #  #  #############  #######
#  #  #  #     #        #  #  #  #  #        #  #     #           #  #     #        #     #
#  ####  #  #  #############  ####  ##########  #  #  #######  ####  ####  #  #  #  ####  #
#        #  #              #           #           #     #  #  #              #  #        #
####  ####  ####  ####  #  ####  ####  ###################  #  #######  ##########  #######
#  #     #  #  #  #     #  #        #  #        #  #  #        #     #  #        #        #
#  #  #######  #  #######  ####  #  #  ####  #  #  #  #  ####  #  #############  #  #  #  #
#  #     #     #  #              #  #        #     #  #     #     #  #           #  #  #  #
#  #  ####  #  #  #  #  ###################  #  #  #  #######  ####  #  #######  #  #  ####
#  #  #  #  #  #  #  #        #     #  #     #  #  #     #           #  #     #     #     #
#  #  #  #  ####  #  #  #  #######  #  #  ##########  #  ################  ####  ####  #  #
#        #     #  #  #  #     #        #     #     #  #  #           #           #     #  #
#  #  #######  ################  #############  #######  ####  ####  ################  #  #
#  #           #        #                 #  #  #  #              #  #     #     #     #  #
#  ####  #############  #  #######  #######  #  #  #######  ####  #######  #  #############
#  #           #  #        #  #  #  #              #  #  #  #                    #  #     #
#  ####  ####  #  #######  #  #  ####  #############  #  ####  #  #######  #  ####  #  #  #
#  #     #        #  #           #  #           #  #        #  #     #  #  #        #  #  #
#  ####  #######  #  ##########  #  ##########  #  #  ####  ####  ####  #  #  ####  #  ####
#  #     #  #     #              #              #        #     #  #     #  #     #     #  #
####  ####  #############  ##########  #######  ####  ####  #  ####  #######  ####  ####  #
#              #                 #     #        #  #  #  #  #  #  #  #  #  #  #        #  #
#  ################  ####  #  ####  #######  ####  #  #  #  ####  #  #  #  #######  ####  #
#     #  #           #     #           #     #     #  #                 #     #     #     #
####  #  #  #######  ####  #  ##########  #  #  ####  ####  #######  #######  ####  ####  #
#  #              #     #  #  #     #  #  #  #  #     #  #        #  #        #     #     #
#  ##########  #  #######  ####  ####  ####  #  #  ####  #  #  ####  #  ####  ####  #  #  #
#  #  #        #  #        #           #  #     #  #        #     #        #           #  #
#  #  #  #############  ####  #  #  #  #  #  #  #  #######  #  #  #######  #  #  ####  #  #
#  #           #  #           #  #  #  #     #        #     #  #  #     #  #  #  #  #  #  #
#  #  #  #######  ##########  ####  ####  ####  #  #  #  ##########  #  #######  #  ####  #
#     #     #     #           #  #     #  #     #  #  #     #        #  #     #     #     #
#  ####  #  #  #  #  ##########  #  #  ####  ##########  #  #  ####  ####  ####  #  #######
#     #  #  #  #  #  #              #  #     #     #     #     #  #     #        #        #
#  #  #######  #######  ####  #  #  ####  ####  #######  #  ####  #  ##########  #  ####  #
#  #        #     #  #     #  #  #     #        #     #  #  #     #  #     #  #  #     #  #
####  #  ####  #  #  ####  #  #  ####  #############  #  #  ####  #######  #  ####  ####  #
#     #        #     #     #  #  #                 #     #                    #     #     
########################################################################################  
