   ##########################################################
                     #                       #     #        #
####  ##########  #######  #  ####  #############  ####  #  #
#              #           #  #  #  #  #           #     #  #
#######  #######  #  #  ####  #  ####  ####  ##########  #  #
#        #  #  #  #  #     #                             #  #
####  #  #  #  #  ####  #############  #  ####  #######  #  #
#  #  #  #     #  #        #        #  #  #  #  #     #  #  #
#  ####  #  ##########  #  ####  ####  ####  #######  #  ####
#  #           #        #  #        #     #     #           #
#  #  ################  ####  ####  #######  #  #  #  #  #  #
#     #        #              #        #  #  #  #  #  #  #  #
#  ####  ####  #  #  #  #############  #  #  #  #  ##########
#  #     #     #  #  #           #     #     #  #     #  #  #
#  #  #  ####  #  ###################  ####  ##########  #  #
#     #  #     #  #              #  #           #  #        #
#  ####  #  ##########  #######  #  #  #  #  #  #  ####  ####
#  #  #  #  #     #     #     #     #  #  #  #  #           #
####  ##########  #  ####  #######  ####  ####  ####  #######
#  #     #  #     #     #     #           #  #  #     #  #  #
#  #  #  #  #  #  ####  #  #  ##########  #  #  #  #  #  #  #
#     #        #  #  #     #  #  #  #        #  #  #     #  #
#  #  #############  ####  ####  #  ##########  #######  #  #
#  #  #     #              #  #  #                 #  #     #
#  ####  #  ####  ##########  #  #######  #  ####  #  #  #  #
#  #  #  #  #  #  #           #     #     #     #        #  #
#  #  #  #  #  #  #  #############  #  #############  ####  #
#  #     #        #  #                       #  #     #     #
#  #  #######  ####  ####  #############  ####  ##########  #
#           #     #  #        #                          #  #
##########  ####  #  #  ##########  ####  ####  ##########  #
#           #     #        #           #  #           #  #  #
#  #######  ####  ####  #  ################  #  #######  #  #
#        #  #     #  #  #     #     #        #        #  #  #
#  ##########  #  #  #######  #  #  ##########  ####  #  ####
#        #     #     #           #        #        #     #  #
#  ##########  #  #  #  #  #  ####  ####  #  #  #######  #  #
#     #  #     #  #  #  #  #  #        #  #  #  #  #  #     #
#  ####  ################  #######  ####  #######  #  #  #  #
#  #                          #        #        #        #  
##########################################################  
