   #########################################################################
      #        #  #        #  #           #                 #              #
#  #######  #  #  #  ####  #  ####  #  ##########  ####  ####  #############
#           #  #  #     #        #  #              #           #  #  #     #
####  ####  ####  #######  #  ##########  ####  #  #######  ####  #  ####  #
#     #  #  #        #  #  #     #     #     #  #     #                    #
#  ####  #  #  #  ####  #  #  ####  #  ##########  ####  #  #  ##########  #
#        #  #  #     #  #  #  #  #  #                 #  #  #     #  #  #  #
#  #######  #  #######  #  ####  #######  ##########  ####  #  ####  #  #  #
#        #           #        #     #  #     #           #  #     #  #  #  #
#  #  #  #  #  #######  #  #  #  #  #  ####  ######################  #  #  #
#  #  #  #  #  #  #     #  #     #     #        #  #     #        #        #
#############  #  #######  #  #  #  ####  #######  #  #  #######  ####  ####
#        #     #     #     #  #  #              #  #  #     #        #     #
####  ####  #  ####  #  #  ##########  ####  #  #  #######  ####  ####  ####
#     #     #           #     #     #  #     #  #  #        #     #        #
####  #  ##########  #############  ####  ####  #  #  ####  #  #  #  ####  #
#  #           #     #  #              #  #        #  #        #  #  #     #
#  ####  ####  ####  #  #######  #  #############  ####  #######  #  ####  #
#        #        #  #  #        #  #  #        #     #  #        #     #  #
####  #######  ####  #  ####  #######  #  #######  ####  #  ####  #  ####  #
#  #  #           #     #  #     #     #     #  #  #  #  #  #           #  #
#  #############  #######  #  ####  ####  ####  ####  ####  ####  #  #######
#        #     #     #     #           #     #     #  #     #     #        #
####  #  ####  #  #######  ####  ##########  #  #  #  ####  ####  #  ####  #
#     #           #        #  #           #  #  #              #  #     #  #
####  ####  #############  #  #  ####  #  #  #  #  #######  #  ##########  #
#     #        #     #     #     #  #  #  #  #  #     #     #     #     #  #
####  #######  ####  ####  #  ####  #  #  #  #  ##########  #######  ####  #
#     #              #  #  #     #     #        #              #           #
#  #######  #  #######  #  ####  #  ####  ####  #  #  #############  #  ####
#  #  #  #  #              #     #     #  #  #  #  #  #           #  #  #  #
#  #  #  #############  ####  #  #######  #  #  #######  ####  #  ####  #  #
#              #     #     #  #     #  #  #  #        #     #  #     #     #
#  ####  #  #  ####  #  ####  ####  #  #  #  #  #  #  #  #  #  #############
#  #  #  #  #        #     #  #        #  #     #  #     #  #  #  #        #
#  #  ##########  ####  ####  ####  #######  #############  ####  ####  ####
#     #  #  #  #  #  #     #  #           #        #              #  #     #
#######  #  #  #  #  #############  #######  #############  ####  #  ####  #
#  #     #     #           #     #     #     #     #           #  #     #  #
#  #  #  ####  ##########  ####  ####  #  #  ####  #  #######  ####  ####  #
#  #  #                 #  #  #        #  #        #     #  #        #     #
#  #######  #  #######  #  #  #######  #######  ####  ####  ##########  ####
#  #        #        #  #           #  #        #  #  #     #     #        #
#  #######  #######  ####  ##########  ####  ####  #  #  #######  #######  #
#        #  #     #  #     #     #     #        #  #     #                 #
#  ####  #  ####  #  ####  ####  #  #############  #  ####  #  ##########  #
#     #        #  #  #        #     #  #  #  #              #     #        #
#  #############  #  #  ##########  #  #  #  #  #######  #  #  ####  ####  #
#     #                          #           #  #        #  #  #     #     
#########################################################################  
