   ##########################################################
      #  #  #  #  #     #     #     #  #  #        #        #
#  ####  #  #  #  ####  #  #  #  #  #  #  #  #  ##########  #
#                 #  #     #  #  #  #     #  #  #        #  #
################  #  ####  #######  #  #  #  #  #  ####  #  #
#  #                 #           #     #     #        #     #
#  #  ####  #  ####  ####  ####  ####  ####  ##########  ####
#        #  #  #  #           #     #  #  #  #        #     #
#  #######  ####  #  #######  #######  #  #  #######  #  ####
#        #  #        #     #  #  #        #           #  #  #
####  ####  #  ####  ####  #  #  #  #######  #  #  #  ####  #
#  #     #  #     #  #  #  #     #  #     #  #  #  #        #
#  ####  ####  #  ####  #  #  ##########  #######  ##########
#  #  #     #  #     #     #           #  #                 #
#  #  #  ####  #######  #  #############  #  #############  #
#  #        #     #     #  #  #           #  #           #  #
#  #############  #  #  ####  ####  ####  #  #  ####  #######
#     #     #        #        #     #     #     #     #     #
#  ####  #############  ################  ####  #  ####  #  #
#        #              #        #           #  #     #  #  #
#  ####  #  ##########  #  ####  #######  #  #  ##########  #
#  #  #  #        #     #  #              #  #     #     #  #
#  #  #  ####  ####  #  #  #  #######  #  ####  #######  #  #
#  #     #  #     #  #  #  #     #     #        #     #     #
####  ####  #  #######  #  ####  ####  ####  #######  #  ####
#  #  #     #     #  #  #     #     #  #              #     #
#  #  ####  #  ####  #  #######  ##########  #############  #
#     #        #           #     #  #  #        #  #        #
#  ####  #  #  ##########  #  ####  #  #######  #  #  #  ####
#     #  #  #  #  #  #                    #  #  #     #  #  #
#  #  #  #######  #  #  ####  #  ##########  #  #  #  ####  #
#  #     #     #           #  #  #     #  #        #  #     #
#  #######  #  #######  #  #  #  #  ####  #######  #  #  ####
#     #     #        #  #  #  #  #        #  #     #  #  #  #
#  #######  #  ####  #  #  #  #  #  #######  ####  ####  #  #
#     #     #     #     #  #  #  #  #  #        #        #  #
#  #  #######  #  ####  #  #  ####  #  #  ####  ##########  #
#  #     #     #  #     #  #        #  #  #                 #
#  #############  #  ##########  ####  #  ####  ##########  #
#           #     #     #                    #        #     
##########################################################  
