   ##########################################################
               #           #           #        #           #
#  ####  #  ####  #  #  #  ####  #######  ####  ####  #  #  #
#  #     #        #  #  #  #        #  #  #  #  #  #  #  #  #
####  #############  ##########  ####  #  #  #  #  #  #######
#     #                 #           #     #                 #
#  #######  ####  #######  ##########  ##########  #  #  ####
#  #        #           #                    #     #  #     #
#######  ####  #  #######  #######  #######  ################
#           #  #              #     #     #        #  #     #
#  ####  #  ####  #  ################  ####  #######  #  ####
#     #  #     #  #        #  #  #              #     #  #  #
####  ##########  ####  ####  #  #  #  #######  #  ####  #  #
#  #  #  #        #        #        #     #     #     #     #
#  ####  ####  #######  ####  #######  #  #  ####  #  ####  #
#              #        #        #     #  #  #     #  #     #
#######  #  #  #############  ################  ####  #  ####
#     #  #  #  #              #           #        #  #     #
#  ##########  #  #######  #######  ##########  #######  #  #
#  #           #  #     #     #  #  #              #     #  #
#  ##########  ####  #  #  #  #  #  ####  #  ##########  ####
#  #              #  #     #        #     #                 #
#  #  #######  #  ####  #######  #  ####  ###################
#           #  #  #  #     #     #           #        #     #
#  #######  ####  #  ####  #  #######  #############  #  ####
#  #  #     #        #  #  #        #  #  #     #        #  #
#  #  ####  #  #  ####  ####  #######  #  #  #  ####  #  #  #
#     #     #  #     #        #  #           #  #     #  #  #
#  #  #  #######  ##########  #  #  ####  #  ####  #  #  #  #
#  #  #  #  #  #  #           #     #     #     #  #  #  #  #
#  #######  #  #  ####  #######  #############  #  ####  #  #
#        #     #  #           #  #              #  #  #  #  #
#######  ####  #  ####  ####  ##########  ####  #  #  #  #  #
#     #     #     #  #     #  #  #        #           #     #
####  #  #  ####  #  #  #  ####  ####  #######  ####  ####  #
#     #  #  #     #     #  #  #     #  #  #     #  #     #  #
#  #  #  #  ####  ####  ####  ####  ####  ####  #  #  #######
#  #  #  #     #  #  #  #     #     #     #        #  #     #
#  #  #  #  #  #  #  #######  #  #  #  ####  #############  #
#  #     #  #  #        #        #                          
##########################################################  
