   ############################
   #  #                       #
#  #  ####  #############  #  #
#     #     #     #     #  #  #
#  ####  #######  #  #  #  ####
#  #           #     #  #  #  #
#  #######  #  #######  #  #  #
#     #     #  #  #  #        #
#  #######  ####  #  #  #######
#        #  #        #        #
#  #######  #  #############  #
#        #                 #  #
####  #######  #############  #
#     #           #  #  #  #  #
####  ####  #  ####  #  #  #  #
#           #              #  #
#  ##########  ####  ####  ####
#           #  #     #        #
#  ####  #  #######  #######  #
#  #     #     #     #        
############################  
