   #########################################################################
               #        #           #        #  #     #     #  #           #
####  ####  ##########  ####  #############  #  #  #  ####  #  #  #  #  #  #
#  #  #  #  #  #        #     #        #  #        #     #     #  #  #  #  #
#  #  #  #  #  #  #  #  #  ####  #  #  #  ####  #############  ##########  #
#        #     #  #  #        #  #  #     #     #  #     #  #     #     #  #
####  #  #  #  #  #  ####  #  #######  #  #  #  #  ####  #  #  #  #  ####  #
#  #  #  #  #     #  #     #  #        #     #  #  #  #        #  #     #  #
#  #  ####  #######  #######  #######  ##########  #  ##########  #  ####  #
#        #     #        #  #           #        #        #           #  #  #
####  ####  #  #  #######  #  #  ####  #  #  #  ####  #######  #######  #  #
#  #     #  #  #  #     #  #  #     #  #  #  #     #                 #     #
#  #  ####  #######  ####  ####  #  ####  #######  #  #  #  ####  ####  #  #
#        #  #  #     #           #  #           #     #  #  #  #  #     #  #
#############  ####  #  #  #######  #######  #  #  ##########  ##########  #
#        #  #     #  #  #     #              #  #  #  #     #     #        #
####  ####  #  ####  #######  #  ################  #  ####  ####  ####  #  #
#        #     #     #        #     #  #     #     #  #                 #  #
#  ####  ####  #  ####  #  #  #######  #  #  #  ####  ##########  ##########
#  #     #        #  #  #  #  #  #        #        #           #     #  #  #
#######  #  ####  #  #######  #  #  ####  #######  ####  ####  #  ####  #  #
#     #        #  #              #  #        #  #  #        #              #
#  ##########  ####  ##########  #  #######  #  #  ####  #  #######  #  #  #
#     #        #     #  #  #  #  #     #        #  #  #  #     #     #  #  #
####  #  #  ####  #  #  #  #  #  ################  #  #############  ####  #
#     #  #     #  #  #           #  #  #     #  #        #           #  #  #
#  #  ####  #  #######  #######  #  #  #  ####  #  #  #######  ####  #  ####
#  #  #  #  #     #  #     #  #        #  #  #     #     #     #           #
#  ####  #  #######  #  ####  #######  #  #  #  #######  ####  #  ####  ####
#     #  #  #        #        #  #  #  #     #  #     #  #  #  #     #     #
####  #  #  #  ####  #######  #  #  #######  #  ####  ####  #  #######  #  #
#     #     #     #              #  #        #           #           #  #  #
#  ####  #  ####  ##########  #  #  #  #  #######  #######  ####  ####  ####
#  #     #  #           #     #  #  #  #                    #     #  #     #
#  #  #######  #############  ####  ####  ######################  #  #  #  #
#  #        #           #  #  #  #  #  #           #  #  #  #        #  #  #
#  #  ####  ####  ####  #  #  #  #  #  ##########  #  #  #  #  #  #  #######
#        #     #  #  #  #  #  #              #     #  #     #  #  #     #  #
#  ##########  #  #  #  #  ####  #  #######  #######  #  #######  #######  #
#        #        #           #  #        #        #     #              #  #
#  ##########  #  #  ####  #######  ####  ##########  #  #######  #  #  #  #
#     #     #  #  #  #  #  #     #  #     #           #  #  #     #  #     #
#  ####  #######  ####  #  #  #  ####  #  ####  ##########  #  #  ##########
#  #  #     #     #  #  #  #  #  #     #  #     #  #     #     #     #     #
#  #  #  ##########  #  #######  #######  #  ####  #  #######  ####  #  #  #
#     #           #  #     #  #                 #  #  #           #     #  #
####  #  #  ####  #  #  ####  ####  ####  #######  #  ####  ####  ####  #  #
#  #     #  #  #  #  #  #              #  #           #        #     #  #  #
#  #  #######  #  #  #  #  #######  ##########  ####  ##########  #  ####  #
#        #           #        #                 #                 #  #     
#########################################################################  
