   #########################################################################
      #     #        #     #           #     #     #           #  #     #  #
#  #  #  #  ####  ####  ##########  #######  ####  #######  ####  #  ####  #
#  #  #  #  #  #              #              #                 #           #
####  ####  #  ####  #  ##########  ####  ################  ####  #######  #
#                 #  #     #     #     #  #                       #        #
#  ####  #######  #######  #  ##########  #  ####  #  ####  #############  #
#  #     #  #                    #        #  #     #  #           #     #  #
####  ####  ##########  ##########  #######  #######  #######  #  ####  ####
#              #  #        #     #              #        #  #  #  #        #
####  #######  #  #  #  #  ####  #  ####  #  #  ####  ####  ####  #  ####  #
#     #  #        #  #  #  #        #     #  #  #     #  #     #        #  #
####  #  ##################################  #  #  ####  #  ####  #  #######
#     #     #     #  #           #  #        #  #     #        #  #        #
#  #  #  #######  #  #  ##########  ####  #######  ####  ##########  #######
#  #  #     #  #  #           #  #     #  #  #        #     #        #  #  #
#  #  #  ####  #  #######  #  #  #  ####  #  #  #######  ####  #######  #  #
#  #        #     #        #  #           #     #  #  #     #     #        #
####  #  ####  ##########  ####  ####  #######  #  #  ####  #  #  ####  ####
#     #  #        #           #     #     #        #           #  #     #  #
####  ##########  ##########  ####  #  #############  #############  #  #  #
#     #     #     #                 #     #  #     #     #  #  #  #  #     #
####  ####  #  ####  ################  ####  ####  #  ####  #  #  ####  #  #
#  #        #              #        #     #  #           #  #  #        #  #
#  #  #  #  ####  ################  #  #  #  ####  #######  #  #  ##########
#     #  #  #           #  #        #  #     #                       #     #
#######  #  #  #######  #  ####  #######  #######  #  #  ##########  ####  #
#        #  #     #     #     #  #  #     #     #  #  #        #     #     #
#  #  ####  #  ####  #######  #  #  ####  #  ####  ####  #  #  ##########  #
#  #  #  #     #  #     #  #        #     #        #     #  #  #     #     #
#  ####  ####  #  #######  ####  ####  #  ####  ################  #######  #
#     #     #           #  #        #  #     #     #     #     #           #
####  #  #######  #  #  #  ####  #  #  ####  ####  ####  #  ##########  #  #
#  #  #     #     #  #        #  #  #  #     #     #  #  #  #           #  #
#  ####  #######  #  ####  #######  ##########  ####  #  #  ####  ####  ####
#                 #  #     #           #  #  #        #              #     #
#######  #  ####  ####  #  #  #  #######  #  #  #  #  ####  ####  #######  #
#     #  #  #        #  #     #     #        #  #  #        #  #  #        #
####  #  ####  ##########  #############  #  ####  ####  ####  #  #  #######
#  #     #  #           #  #        #     #  #  #  #        #  #  #  #     #
#  ####  #  ####  #  #  ####  ####  #######  #  #######  ####  #######  #  #
#           #     #  #     #     #        #  #        #        #     #  #  #
#  #######  ####  #######  #  #  #######  #  #######  #  #  ####  #######  #
#     #     #     #        #  #  #     #     #     #     #     #           #
#  ####  ####  ####  ####  #######  #  ####  #  ####  ####  ####  #  #  ####
#     #  #  #     #     #     #     #              #  #  #        #  #     #
#  #######  ####  #############  #  ####  #  #  #  #  #  #  ####  #######  #
#  #                          #  #     #  #  #  #  #     #     #  #  #     #
####  #  ####  ####  #######  #  #  #  #######  #  ####  #  #######  ####  #
#     #     #     #  #        #  #  #        #  #        #        #        
#########################################################################  
