   ##########################################################
            #        #  #  #     #     #  #        #     #  #
####  #  ####  ####  #  #  #  #######  #  #  #  #  #  ####  #
#     #     #     #  #  #     #  #     #     #  #  #  #     #
#  ####  ####  #######  ####  #  #  #  ##########  #  #  ####
#  #  #  #     #  #        #     #  #  #  #           #     #
#  #  ####  #  #  #  #  #######  ####  #  #  #############  #
#        #  #        #  #  #     #  #        #     #  #     #
#  ####  #######  #######  #  ####  #######  ####  #  #  #  #
#  #        #     #  #        #     #           #     #  #  #
#  #  #  #######  #  #  #  ####  #######  ####  ####  #  #  #
#  #  #  #              #     #     #  #  #           #  #  #
#  ####  ####  #  #  ####  ####  ####  #  ####  ####  #  ####
#  #  #  #     #  #  #     #  #  #  #        #  #  #     #  #
#  #  #  ####  #######  ####  #  #  ####  #######  #  ####  #
#     #  #  #  #     #  #  #        #     #        #  #     #
####  ####  #######  #  #  ####  #############  ####  #  ####
#  #                 #        #  #        #           #     #
#  #  ##########  ##########  #  ####  #  ####  ####  #  ####
#     #     #           #     #  #     #  #        #        #
####  ####  ####  #  #  ####  #  ####  ####  ####  ##########
#  #  #     #  #  #  #        #           #  #              #
#  #  #  ####  ##########  #######  #  ##########  #  ####  #
#        #        #                 #  #           #  #  #  #
####  #  #  #######  ####  ####  ##########  ##########  #  #
#  #  #  #  #        #  #  #        #  #  #     #           #
#  #######  ####  ####  #############  #  #  #######  ####  #
#  #                          #        #           #  #     #
#  #############  #  #  ##########  #  #  ####  #############
#                 #  #  #  #        #  #  #        #        #
####  #  #######  #######  #  ####  #######  ####  #  ####  #
#     #        #        #        #  #     #     #     #  #  #
####  #  ####  #  #  ####  ####  #  ####  ####  #  ####  ####
#     #     #  #  #     #  #     #  #           #  #  #     #
#  #  #######  #  ####  #  #######  #  #######  #  #  #  ####
#  #  #     #  #     #     #              #  #  #  #        #
####  ####  #  #######  ####  #  ##########  ####  #  #######
#  #     #     #     #  #     #        #     #           #  #
#  ####  #######  #  #  #######  ####  ####  ####  #  #  #  #
#        #        #        #        #           #  #  #     
##########################################################  