   #########################################################################
               #              #        #        #        #                 #
####  #  ##########  ####  #  ####  #  #  #  #######  ####  #  #############
#     #     #        #  #  #        #  #  #                 #     #  #     #
#######  ##########  #  #############  #######  ################  #  #  #  #
#     #              #     #  #                 #  #  #     #           #  #
#  #######  #######  #  ####  #  #  #  ####  ####  #  ####  ####  #  #  ####
#     #           #     #        #  #  #  #     #  #        #  #  #  #  #  #
#  #######  #############  ####  #######  #  #  #  ####  ####  #  ####  #  #
#        #           #     #  #  #  #        #  #  #        #     #  #     #
####  #######  ##########  #  #  #  ####  #######  ####  #  ####  #  #######
#        #           #        #  #  #     #  #           #     #  #  #     #
####  #  ####  #######  #######  #  #######  #  #######  #  #  ####  #  #  #
#     #              #     #  #  #           #  #     #  #  #  #     #  #  #
#  ####  #  #######  ####  #  #  ####  ####  #######  ####  ####  ####  ####
#  #  #  #        #  #  #     #        #           #     #           #  #  #
####  ##########  ####  ####  #  ####  #  #  ####  #  #######  ####  #  #  #
#  #     #  #     #        #  #  #  #  #  #  #                 #           #
#  ####  #  ####  #  #######  ####  #######  #  ##########  ####  ####  #  #
#     #              #  #        #        #  #  #        #  #  #  #  #  #  #
#  #  ####  ####  #  #  ####  #######  #######  ####  #######  #  #  #  #  #
#  #           #  #        #     #     #        #        #  #  #  #     #  #
#  #######  ####  #######  #  ####  #######  #  ####  ####  #  #  ##########
#  #  #     #     #        #           #     #        #        #     #     #
#  #  #######  ####  ################  #  ##########  #  #  ##########  #  #
#  #     #     #     #     #  #     #  #  #  #  #        #  #  #  #     #  #
#  #  ###################  #  #  #  ####  #  #  #  #  #######  #  #  #######
#  #     #     #  #     #  #     #  #           #  #           #           #
#  #  ####  #  #  #  ####  ####  ##########  #############  #  #  #  #######
#        #  #           #        #  #     #        #  #  #  #     #  #     #
####  ####  ####  #  #######  ####  #  #  #######  #  #  ####  #######  ####
#  #  #  #  #     #  #     #        #  #  #  #           #     #           #
#  ####  ##########  #  ####  #  #######  #  #############  ##########  ####
#  #        #     #           #  #     #  #     #     #                    #
#  ####  #  #  ####  #  #  #  #######  #  #  ####  ##########  ##########  #
#  #  #  #     #     #  #  #                 #     #                 #     #
#  #  #  ####  #  #############  ##########  #  #  ###################  ####
#     #  #     #     #     #     #     #     #  #        #        #        #
#  #  ####  #  #  ####  #  #######  ####  #  #######  #  #  #  #  #  ####  #
#  #        #     #     #  #           #  #  #  #     #     #  #        #  #
####  #  ####  #  #  #############  #  ####  #  #######  #  ####  ####  ####
#     #  #     #  #     #           #  #  #     #     #  #     #     #     #
####  #######  #  ####  ##########  ####  #  #  #  #  ####  #  ####  ####  #
#     #        #  #     #  #        #     #  #     #     #  #  #  #  #  #  #
####  ####  #######  #  #  ####  #######  #  #  #  ####  ####  #  ####  #  #
#        #  #     #  #  #  #     #     #     #  #  #     #  #  #           #
#  #######  #  #######  #  #  #######  ####  #  #######  #  ##########  ####
#  #  #  #              #  #                 #     #     #     #           #
#  #  #  ################  #  #######  #######  #  ####  #  #############  #
#  #                          #              #  #  #                       
#########################################################################  
