   ######################################################################################################################
   #  #        #  #        #              #        #        #  #              #  #     #     #        #                 #
#  #  #  #  #  #  ####  ####  #######  ####  ####  #  ####  #  ##########  ####  ####  ####  #  ####  #######  #######  #
#  #  #  #  #                 #  #              #        #     #              #     #  #     #  #              #        #
#  #  #  ####  ################  ##########  #  #############  ####  #  #######  ####  #  #  #  #######  ####  #  ####  #
#        #     #     #  #     #              #     #  #  #     #     #                    #  #        #  #  #  #  #     #
#  #  #######  ####  #  #  #  #  ####  ####  #######  #  ##########  ##########  #######  ####  #  #######  #  #######  #
#  #     #     #  #     #  #     #     #     #  #                             #     #     #  #  #     #     #  #        #
#  ##########  #  #  ####  ####  #  #  ####  #  #  #  #############  ################  #  #  #  #  #######  #  #  ####  #
#     #           #  #     #     #  #  #  #  #  #  #     #  #     #        #     #     #        #     #        #  #     #
#  #######  #######  #  #  ####  #######  ####  #######  #  ####  ####  ####  #  #  #############  ####  #############  #
#        #  #        #  #     #        #  #     #     #     #     #  #  #  #  #     #  #     #     #           #     #  #
#  #############  #######  ####  #  ####  #  #######  #  #  ####  #  ####  #  #  ####  ####  ##########  #######  #  #  #
#  #     #              #     #  #     #     #        #  #                 #  #           #     #  #     #  #     #     #
####  ####  #  ###################  ####  #  #  ##########  #######  #######  ####  #  ####  #  #  #  #  #  ####  #######
#     #  #  #     #           #  #  #  #  #           #     #        #  #     #     #     #  #     #  #  #              #
####  #  #  ####  #  #######  #  #  #  #  ##########  ####  #######  #  #  #  #  #  #######  #############  #  #######  #
#              #  #        #     #  #        #                 #  #     #  #  #  #  #           #           #        #  #
#  #  ####  #  #############  #  #  #  #######  ####  #######  #  #  ####  #######  #  #######  ##########  ##########  #
#  #  #     #     #     #     #        #  #        #  #     #  #     #     #        #  #  #  #  #        #  #           #
#  #############  #  ##########  #  ####  #  #######  #  ####  #############  ####  ####  #  #  ####  ##########  ####  #
#  #  #        #  #           #  #  #     #  #        #        #  #           #  #  #     #  #  #  #  #     #  #  #     #
####  #  #  #  #  ##########  #######  #  #######  ##########  #  #  #  #######  #  #  ####  #  #  #  #  ####  #######  #
#        #  #        #           #  #  #  #        #        #  #     #     #        #                 #              #  #
#  ###################  #  ####  #  #  #######  ##########  ####  #######  #############  #######  ##########  ##########
#        #     #  #  #  #  #  #                          #  #        #     #              #        #        #  #  #     #
#  ##########  #  #  #######  #  ####  ###################  #######  #  #  ##########  #  #######  ####  ####  #  ####  #
#  #  #     #     #  #  #  #     #        #  #              #     #  #  #     #        #  #        #  #                 #
#  #  #  #  ####  #  #  #  #  #######  ####  ####  ####  ####  #  ####  ##########  #############  #  #######  ####  ####
#  #     #     #        #     #  #     #  #  #  #  #        #  #     #     #        #  #  #           #     #  #        #
#  ####  ####  #  #  #######  #  ####  #  #  #  #  #  #######  #  #  #  #############  #  #  #######  ####  #  ##########
#  #  #  #  #  #  #                 #  #        #  #     #  #  #  #        #  #        #     #  #  #           #        #
#  #  ####  #  ##########  #  ##########  ####  ####  ####  #  #  ####  ####  ####  ####  ####  #  #  #  #######  ####  #
#        #        #  #  #  #  #  #  #  #  #        #        #  #  #  #        #     #     #  #        #        #     #  #
####  ####  ####  #  #  #  ####  #  #  #  #  #  ####  #  #######  #  ####  #######  ####  #  ####  ####  #######  ####  #
#        #     #  #              #  #     #  #        #  #     #     #     #     #           #        #     #  #     #  #
####  ####  #######  ##########  #  #######  ################  ##########  ####  #  #  ################  ####  #######  #
#     #  #           #     #        #        #        #  #     #        #     #  #  #        #  #        #  #           #
#  ####  #  ####  ####  ##########  #  ##########  #  #  #  ##########  ####  #  #  ####  #  #  #  #######  #######  ####
#     #  #  #              #                 #     #  #        #           #  #     #  #  #  #        #     #  #        #
#  #  #  #  #  #  #  ##########  #######  #  ####  ##########  ####  #  ####  #  ####  #######  ####  #  ####  #  ####  #
#  #        #  #  #  #           #  #  #  #  #     #  #           #  #     #        #  #     #  #        #     #  #     #
#  #  ####  #######  #  #  ####  #  #  #  #  ####  #  #######  #  #######  ##########  ####  #  #  #  #  #  #  #######  #
#  #  #  #     #  #  #  #  #  #  #        #  #  #              #  #     #  #     #  #           #  #  #     #  #        #
#  ####  #######  #######  #  ####  #  ####  #  #############  #######  #  ####  #  #  ##########  ####  #######  ####  #
#  #  #  #              #  #     #  #  #     #           #  #  #        #           #        #  #  #     #  #     #     #
#  #  #  #  #######  ####  ####  #  #  ####  #######  ####  #  #######  #  #######  #  #######  #  ####  #  #  #######  #
#        #  #        #     #     #  #     #  #        #     #     #  #     #  #     #  #     #        #           #  #  #
#  #############  #  #  ####  ##########  #  #  #######  #  #  ####  #  #  #  ####  #  ####  #######  #  #######  #  #  #
#              #  #     #  #     #        #  #        #  #  #           #     #           #  #        #        #  #  #  #
#  #  #  #############  #  #  ####  #  #  #  #  #  ####  #############  #  #  ####  #  ####  #  #  ####  #  #  ####  #  #
#  #  #              #  #           #  #  #     #           #  #        #  #  #     #     #     #     #  #  #  #  #     #
#######  ####  ####  ####  #  #######  ####  #  #############  ####  ####  ##########  #######  ####  ####  ####  ####  #
#  #  #     #  #     #  #  #  #     #  #  #  #     #     #        #     #  #              #     #  #  #           #  #  #
#  #  #  #############  #######  #######  #######  #  #  #  #  ##########  #  #######  ##########  #######  #######  #  #
#     #     #        #           #     #              #     #  #     #     #  #     #        #  #     #           #     #
#  #######  ####  #######  #  #######  #  ####  #  #  #  ##########  #  #  #######  #  #######  ####  #  #  #  #  ####  #
#        #  #              #     #  #  #  #  #  #  #  #              #  #  #     #  #        #           #  #  #  #  #  #
####  ####  #  #  #  ####  ####  #  #  ####  #  ##########  ##########  #######  #  ####  ####  #  #######  #######  #  #
#  #        #  #  #  #     #           #           #     #  #  #     #     #        #     #  #  #     #     #     #  #  #
#  ################  #  #  ##########  #######  #  #  #  ####  ####  #  ####  ####  #  ####  #  ##########  ####  #  #  #
#           #  #     #  #        #     #  #     #     #     #           #  #     #           #        #  #  #           #
#  ####  ####  #  #######  ####  #######  #  ################  ##########  #  ####  ####  #  ####  ####  ################
#  #     #  #     #  #     #  #              #  #     #  #  #        #           #  #     #     #              #  #     #
####  ####  #######  #######  #  ##########  #  #  ####  #  #  #  ####  #  #############  ####  ####  #  #  #  #  ####  #
#        #           #     #  #     #        #     #  #  #  #  #     #  #  #              #        #  #  #  #     #  #  #
#  ################  ####  #  #  #  #  #######  ####  #  #  ####  ####  #  #  #######  #######  ####  ####  #  ####  #  #
#        #           #     #     #  #                 #              #  #  #  #  #  #  #           #     #  #           #
#  #  #  ####  #  ####  ####  ##########  #######  #  #  ####  #  #############  #  #  #######  #############  ####  ####
#  #  #  #  #  #     #     #  #        #     #  #  #  #  #  #  #     #              #  #     #  #        #     #  #     #
####  #  #  #  ####  ####  #  #  #  #######  #  ##########  #######  #  #  #######  ####  #######  ####  ####  #  #  #  #
#     #     #     #  #     #     #     #        #     #        #     #  #  #        #     #     #     #     #     #  #  #
#  #  ####  #  #  ####  ####  #  ####  ####  ####  ####  #############  #############  #######  ####  #  #  ####  ####  #
#  #  #     #  #     #        #     #  #        #           #        #        #           #     #  #  #  #  #        #  #
##########  #  #######  #######  #  ####  #  #  #  ####  #  #######  #######  #  ####  #  ####  #  ####  ####  #######  #
#        #     #     #        #  #     #  #  #     #     #     #     #     #        #  #        #                    #  #
#  ##########  #  ####  #  #  #  #############  #  #  #######  #  ####  ####  #  ####  ####  #######  ##########  #######
#                       #  #  #  #              #  #     #  #     #           #  #  #  #  #     #     #  #              #
#  #######  #######  ####  #  ####  #######  #  #######  #  #  #  #  #  #  #######  ####  #  ####  #  #  #  ####  ####  #
#  #           #     #     #     #     #     #     #        #  #  #  #  #        #                 #     #  #     #     
######################################################################################################################  
