   ##########################################################
      #  #        #              #     #     #  #           #
#  ####  ####  #  #######  #  ####  #######  #  ####  ####  #
#  #  #        #     #     #        #     #     #     #     #
#  #  ##########  #  #  ####  ####  #  ####  #######  #  ####
#  #        #     #  #     #     #  #        #        #  #  #
#  #  #######  #######  #  #######  ####  #######  #######  #
#                       #     #  #     #              #  #  #
#  ####  ######################  #  ####  #######  ####  #  #
#  #     #           #     #           #     #  #  #     #  #
####  #######  ####  #  ##########  #  #######  #  #  ####  #
#           #     #  #  #     #  #  #     #  #              #
#  #  #  ####  #######  #  ####  #  ####  #  #######  #  ####
#  #  #  #                    #     #  #           #  #     #
#  #  #  #######  #######  ####  ####  #  #  #  #######  #  #
#  #  #     #  #  #     #     #  #     #  #  #  #        #  #
####  ####  #  #######  ####  #  ####  ####  ####  ####  ####
#     #  #  #  #        #           #           #     #     #
#  ####  ####  ####  #  ################  #######  #  ####  #
#  #           #     #              #              #     #  #
#  #  #  ####  #  ####  #######  #######  #############  #  #
#  #  #  #     #  #     #     #  #  #           #  #  #  #  #
#  #  ################  #  ####  #  #  ##########  #  ####  #
#  #           #     #        #              #     #  #  #  #
####  ####  ####  #  ####  #######  #  #  #  #  #  #  #  #  #
#  #  #           #        #     #  #  #  #     #     #  #  #
#  #######  #######  ####  #  ####  #############  #  #  #  #
#  #              #     #  #        #     #  #     #     #  #
#  ####  ##########  #############  #  ####  ####  ####  #  #
#  #  #  #     #                 #  #              #     #  #
#  #  #  ####  ###################  #######  #######  #  ####
#     #        #     #  #        #  #     #        #  #  #  #
#  ####  ####  #  #  #  #######  ####  #######  #  #  ####  #
#        #  #  #  #  #           #  #     #     #  #     #  #
####  ####  ####  ##########  ####  #  #############  ####  #
#  #           #  #        #        #           #  #        #
#  #  #  ####  #  ####  ####  ##########  #######  #  ####  #
#     #     #  #  #           #        #  #     #     #  #  #
#  ##########  #  #  #  #  #  ####  ####  #  #  ####  #  #  #
#        #     #     #  #  #                 #           #  
##########################################################  
