   ##########################################################
            #        #  #     #  #  #     #     #        #  #
#  #######  ####  #  #  ####  #  #  ####  #  #######  #  #  #
#  #        #  #  #  #           #  #        #     #  #     #
#  ####  #  #  #  #  #######  #  #  #  #######  #######  ####
#  #     #  #  #  #     #  #  #              #              #
####  #  #  #  #######  #  #######  #######  #  ####  ####  #
#     #  #     #     #        #     #     #  #  #     #     #
#######  ####  ####  #  #  #  #  ####  ###################  #
#  #        #  #        #  #  #  #     #           #     #  #
#  #  #  #######  #  ##########  ####  #######  #######  #  #
#     #     #     #  #     #                 #  #        #  #
####  #  #######  #  #  #######  #######  #  #  ####  #  #  #
#  #  #     #     #     #     #        #  #  #     #  #     #
#  #######  #######  #  #  ####  ####  #  #  ####  #  ####  #
#  #     #           #  #     #     #  #  #  #  #     #  #  #
#  #  ####  #######  #  #  ####  ####  #  #  #  #######  #  #
#     #  #  #        #  #     #     #  #  #     #  #        #
#  ####  #############  #  #  ####  #############  #######  #
#     #  #     #     #     #     #  #                 #     #
#  #  #  ####  ####  ####  ####  #  ################  ####  #
#  #  #                    #                    #        #  #
####  ####  #  ####  #  #  #  #  #  ####  #  ####  ####  #  #
#  #  #     #  #  #  #  #  #  #  #  #     #  #        #     #
#  #  #  #  ####  #  #  #  ####  #  ##########  #  ##########
#     #  #        #  #  #  #  #  #     #  #     #     #  #  #
####  ##########  #  #  ####  #  ####  #  #######  #  #  #  #
#                 #  #        #  #     #     #     #  #     #
################  #  ################  ####  ####  #######  #
#     #     #     #  #  #        #           #  #           #
####  ####  ####  ####  ####  #  #  ####  #  #  ##########  #
#     #                       #  #  #     #  #              #
####  #  #  #######  #  #  #############  #  ####  #  ####  #
#        #  #     #  #  #  #  #        #  #  #     #  #     #
################  #  #######  #######  #  #  ####  #######  #
#     #           #  #  #        #  #  #  #        #        #
#  #  ##########  #  #  ####  ####  #  ####  ####  #  #######
#  #                    #              #     #     #  #     #
#  #  ##########  ##########  #  #  #  ####  #######  #  #  #
#  #        #                 #  #  #     #     #        #  
##########################################################  
