   ##########################################################
         #     #  #                 #        #              #
#  #  ####  ####  #  #  #  ##########  #######  #  #  #######
#  #           #  #  #  #  #              #     #  #  #     #
#######  #  #  #  ####  #######  #######  ##########  ####  #
#  #     #  #        #  #           #              #  #  #  #
#  #  #############  #  #  #  #  ####  #  #  ####  #  #  #  #
#           #              #  #     #  #  #     #  #        #
##########  #######  #######  ####  ################  #  ####
#  #           #           #     #  #        #  #     #     #
#  #  #######  ####  #  ####  #  ####  #  ####  ####  ####  #
#  #     #  #     #  #  #     #        #              #     #
#  ####  #  #  #######  #  #######  #  #  #  ####  ##########
#  #  #  #  #  #  #  #  #  #        #  #  #  #     #     #  #
#  #  #  #  #  #  #  ##########  #  #  #############  ####  #
#  #  #  #        #  #  #  #     #  #  #  #     #  #        #
#  #  #######  #  #  #  #  ##########  #  #  ####  #  #  #  #
#  #  #        #     #  #        #  #        #        #  #  #
#  #  #  #  ##########  #  #######  ####  #############  #  #
#        #  #        #  #  #  #     #        #        #  #  #
#######  #  ####  ####  #  #  #  #######  #  ####  ####  #  #
#  #  #  #     #  #  #              #     #        #     #  #
#  #  #  #######  #  #############  #  ###################  #
#  #     #     #     #  #     #                       #     #
#  ##########  #  ####  #  ####  ####  #  ################  #
#        #  #     #        #        #  #  #        #  #     #
#######  #  ####  #######  ####  #######  #  ####  #  ####  #
#           #           #  #  #  #  #  #        #           #
####  ##########  #  ####  #  #  #  #  #######  ####  #######
#        #  #     #     #     #     #  #     #  #  #  #     #
#  ####  #  ####  #  ####  #######  #  #  #######  #  ####  #
#     #     #     #  #              #     #     #  #  #  #  #
##########  #  #######  #  #######  ####  ####  #  ####  #  #
#        #  #        #  #     #                    #  #     #
####  ####  #######  ####  #######  ##########  #  #  #  ####
#                          #        #           #     #     #
################  ####  ####  ####  #######  #  ##########  #
#        #        #     #     #  #     #  #  #  #           #
####  ##########  #  #  #  #  #  #  ####  #  ####  ####  #  #
#                 #  #  #  #  #        #              #  #  
##########################################################  
