   ########################################################################################
      #  #  #  #     #        #     #  #     #        #           #        #              #
#  ####  #  #  #  #  #  #  #  #  #  #  #  #  #  #######  ##########  #  ##########  ####  #
#     #           #  #  #  #  #  #  #  #  #  #        #  #  #        #  #     #  #  #     #
#  #######  #  #  ####  #  #  #  ####  #  ####  #  ####  #  #  #  #  #######  #  #######  #
#  #  #  #  #  #        #  #     #     #  #  #  #  #        #  #  #     #                 #
#  #  #  ####  #  ################  ####  #  #  ####  #  #  #  ####  #  ####  ##########  #
#     #        #  #     #     #  #     #        #     #  #     #     #  #  #     #     #  #
####  #  ####  ####  ####  #  #  ####  ####  ####  #  ################  #  #  ####  ####  #
#     #  #     #     #     #           #  #  #     #              #     #     #  #     #  #
#  ##########  ####  ####  #  ####  #  #  #  ####  ####  #  #######  ##########  #  #  #  #
#  #                       #  #  #  #     #  #  #     #  #  #              #  #  #  #  #  #
#  ####  #######  #  ####  ####  ####  ####  #  #  #  #######  ####  #  ####  #  #  ####  #
#           #     #  #  #     #        #           #  #     #  #  #  #  #     #           #
#  #  #############  #  #############  #######  ####  ####  ####  #  ####  #######  #  #  #
#  #  #  #  #     #        #  #                 #  #  #     #                 #     #  #  #
#  ####  #  #  ####  #  ####  #  #  #######  #  #  ####  ##########  #######  ##########  #
#     #  #  #        #        #  #  #        #  #           #           #                 #
#  ####  #  ####  #  #  ############################  ####  ####  #  ####  #  #  #######  #
#              #  #  #     #  #        #              #           #  #  #  #  #  #     #  #
#######  ##########  #######  ####  #  ####  #######  ####  ####  ####  #  #######  #######
#  #  #           #           #     #     #     #  #     #  #           #        #  #     #
#  #  #  #######  ####  ####  ####  ##########  #  #  #######  #  ####  ##########  ####  #
#           #  #  #     #  #  #     #     #     #     #  #     #  #           #           #
#  ##########  #  #######  #  ####  ####  ####  ####  #  ####  ####  ###################  #
#  #  #  #     #        #        #     #  #  #     #     #        #     #           #  #  #
####  #  ####  ##########  #  #######  #  #  ####  #  #  ####  #  #######  #######  #  #  #
#     #        #           #  #  #              #  #  #     #  #     #           #     #  #
#  #  ####  #  ####  #  #  #  #  #  ############################  ####  #  ##########  #  #
#  #     #  #  #  #  #  #  #     #  #     #     #        #           #  #  #  #     #     #
####  ####  ####  #############  #  ####  #  #  #  #  #  #  #######  ####  #  #  #######  #
#  #  #           #           #  #  #        #  #  #  #     #           #     #     #     #
#  #  #  ####  #  #  ##########  #  #  ####  #  #######  ####  ###################  #  ####
#     #  #  #  #  #     #        #        #  #  #  #        #           #        #        #
#  #  ####  #  #  ####  #  #  #######  ##########  #######  #  #  #######  ####  #######  #
#  #           #  #     #  #  #  #              #  #  #     #  #     #        #           #
####  #  ####  #  #  ####  ####  #############  #  #  ####  ##########  #  ##########  #  #
#     #     #  #           #                 #        #     #           #  #        #  #  #
#  #  #############  ###################  #  #  #  ####  #  #  #  ##########  #  #######  #
#  #  #     #  #     #  #  #  #  #        #     #  #     #  #  #  #           #  #  #     #
#######  #  #  ####  #  #  #  #  #  #############  #######  #  #  #  #############  #  ####
#     #  #  #  #  #                 #  #     #        #        #        #  #  #           #
#  #######  #  #  ####  #  #######  #  ####  ####  ################  ####  #  ####  #######
#     #                 #  #           #     #  #     #  #     #     #  #  #     #     #  #
####  ####  #######  #######  ####  #######  #  ####  #  #  #######  #  #  ####  #  ####  #
#        #     #     #     #  #              #              #        #           #  #     #
####  #  #  ##########  ####  #  ##########  ####  ################  ####  ####  ####  ####
#     #        #     #        #     #        #        #     #           #  #  #        #  #
#  ##########  ####  ####  ####  ################  ####  ##########  #  ####  #  #######  #
#  #           #  #     #  #     #     #  #  #           #  #     #  #     #        #     #
#############  #  #  ####  ####  #  ####  #  #######  #  #  #  #######  ####  ####  #  ####
#  #     #     #        #  #                    #     #           #     #        #        #
#  #  ####  ##########  ####  #  #  #  #  #  #  ####  #  ##########  ####  ##########  ####
#     #  #        #  #     #  #  #  #  #  #  #  #     #  #                    #  #  #     #
#  ####  #  #  #  #  ####  #  #  #  ################  #############  #  ####  #  #  #  #  #
#        #  #  #  #        #  #  #  #        #  #  #  #        #     #  #     #  #     #  #
####  #  #######  #  ####  ################  #  #  #  #######  #######  #######  #  #######
#     #  #     #  #     #        #  #     #  #     #           #        #  #     #        #
#  ####  #  ####  #  ####  ####  #  ####  #  #  ####  #  #  ####  #######  ####  #  ####  #
#  #                    #     #              #        #  #     #              #        #  
########################################################################################  
