   ########################################################################################
   #        #  #           #     #              #        #     #        #              #  #
#  ####  ####  #  ####  #  ####  ####  #######  #  #  #  ####  #  #  ####  ####  #  #  #  #
#                    #  #     #     #     #     #  #  #     #  #  #        #     #  #     #
#######  ####  ##########  #  ####  #  ####  #######  #  #  #  #########################  #
#        #  #  #     #     #  #  #     #  #  #  #     #  #     #  #     #        #        #
#######  #  ####  #  #  #  ####  #  ####  ####  #  #  #######  #  #  ####  ####  #  ####  #
#     #           #  #  #           #        #     #        #     #        #           #  #
#  #  ####  ####  #  ##########  ####  #######  ####  #######  #  ####  #######  ####  #  #
#  #           #  #        #  #     #     #  #     #  #        #  #  #  #  #  #  #  #  #  #
#  #  ####  ####  ##########  #  #######  #  ##########  #  ####  #  ####  #  ####  #  ####
#  #  #     #  #     #     #        #     #  #     #  #  #  #     #     #  #  #     #     #
#############  ####  #  #  #  #######  ####  #  ####  ##########  ####  #  #  #  ####  ####
#           #     #  #  #        #        #        #        #              #        #  #  #
#  #######  ####  #############  ####  ##########  #  ####  ####  #######  #  #  ####  #  #
#        #           #           #                 #     #     #     #     #  #  #        #
#  #  ##########  ####  ##########  #############  #  #######  #  #######  ####  ####  ####
#  #     #        #        #  #  #  #  #  #           #     #        #                    #
#  #  ##########  #  #  #  #  #  ####  #  #  #######  #  #  ####  #  #  ####  #  #  ####  #
#  #     #     #     #  #     #     #     #        #  #  #        #  #     #  #  #  #  #  #
#############  #######  #  ####  #######  #  ####  #############  ##########  ####  #  #  #
#                    #  #        #              #  #  #  #  #     #     #        #     #  #
#  #  #######  #  ####  #  #  ################  ####  #  #  ##########  ####  #######  ####
#  #  #  #     #  #  #  #  #  #     #  #  #     #  #     #        #  #        #        #  #
#  ####  #  #  ####  ####  #######  #  #  ####  #  #  #  ####  ####  #######  #######  #  #
#  #        #                 #                    #  #  #     #  #     #     #           #
#  #######  ##########  ####  #######  #  ####  #  ####  #  #  #  #  #############  #  ####
#        #        #     #        #  #  #     #  #  #        #  #     #        #     #     #
####  #  #  ####  #  #######  #  #  #  #######  ####  ####  #  #  #  #  ##########  ####  #
#  #  #  #  #     #  #     #  #        #  #  #           #  #     #  #              #     #
#  #  #  ##########  #  #  ##########  #  #  #######  ###################  ####  ##########
#     #  #           #  #  #        #        #     #  #        #  #           #  #     #  #
#  #  #  #######  #  ####  ####  #  ####  #  ####  #  ####  ####  #############  #  ####  #
#  #  #        #  #        #  #  #  #     #  #        #              #     #     #        #
###################  #######  ####  ####  ##########  ####  #######  #  #  #############  #
#  #        #     #     #        #  #  #  #           #  #  #           #     #     #     #
#  #  ####  #  ####  #  ####  ####  #  #  #######  ####  #  ####  #  #############  #  ####
#  #  #     #     #  #  #              #        #     #     #     #  #  #     #     #     #
#  #  ####  #  #  #######  #  #######  #  ####  ####  #  #######  ####  #  #  #  #######  #
#        #     #  #     #  #  #           #  #  #  #        #  #     #     #     #  #     #
#  #  ####  #  #  #  #  ##########  #######  ####  ####  #  #  #######  #######  #  #  ####
#  #  #     #  #  #  #  #                 #  #        #  #  #  #     #     #           #  #
#############  ####  ####  #############  #  ####  ####  ####  #  ####  #############  #  #
#     #     #        #  #     #        #     #           #  #        #           #     #  #
#  ####  #  #######  #  #######  #  #  #  ####  ##########  #  #  #  ####  #############  #
#  #     #              #  #     #  #        #  #        #     #  #     #           #  #  #
#  #######  #######  ####  ####  ################  #  ####  #  #  #######  #  #######  #  #
#  #     #  #  #  #  #  #     #     #        #  #  #  #  #  #  #     #     #     #        #
#  ####  #  #  #  ####  #  #  ####  #  ####  #  #  #  #  ####  #  #  #######  #  ####  #  #
#  #     #        #     #  #              #  #     #  #        #  #  #  #  #  #        #  #
#  #  #  ####  #######  #  ####  #  ####  ####  ####  #######  #  ####  #  ##########  #  #
#     #  #  #        #  #  #     #  #  #        #     #  #  #  #           #  #        #  #
#######  #  #  #  ####  #############  #  ####  #  ####  #  #  #  ####  ####  ####  #######
#              #                 #        #     #     #     #  #     #     #        #     #
#  #######  #######  ##########  #######  #######  #######  ####  #  ####  #######  #  #  #
#        #        #        #              #              #        #  #                 #  #
#  ####  #######  #######  #  #  #  #######  #  ####  ####  ####  ####  #######  #######  #
#  #  #  #  #     #        #  #  #  #     #  #  #  #     #     #  #  #     #  #  #     #  #
####  #  #  #######  ##########  ####  #######  #  ####  #######  #  ####  #  #  #  #  ####
#        #                    #     #           #                       #  #        #     
########################################################################################  
