   ##########################################################
            #  #     #     #                                #
#  #######  #  #  #  #  #  ####  #  #######  #######  ####  #
#  #     #  #     #  #  #  #  #  #  #        #           #  #
#  #  #############  #  #  #  ####  ##########  #######  ####
#  #  #        #  #     #     #     #  #        #     #     #
#  #  #  ####  #  #  #######  ####  #  #  ##########  #  ####
#  #     #  #           #  #     #  #  #  #     #  #  #  #  #
#  ####  #  #  #  ####  #  #  #  #  #  #######  #  #  #  #  #
#  #        #  #  #  #  #  #  #        #     #  #     #  #  #
#  ####  ##########  #  #  #######  #######  #  #  #######  #
#                 #     #     #     #  #                    #
####  ####  ####  ####  ####  ####  #  ##########  ##########
#     #  #  #  #  #        #     #  #  #     #     #        #
#  #  #  #  #  #  #######  #  #######  ####  ####  ####  #  #
#  #     #     #  #     #           #  #  #              #  #
#  ##########  ####  #######  #  ####  #  #######  ####  #  #
#     #  #     #     #     #  #     #  #              #  #  #
#  ####  #  ####  #  ####  #######  #  ####  #  ####  #  ####
#  #  #  #  #     #     #     #        #     #  #  #  #  #  #
#  #  #  #######  ##########  #  ####  #######  #  #  ####  #
#           #           #        #  #  #           #        #
####  ####  ##########  ####  #  #  ####  #######  ##########
#     #              #     #  #           #        #     #  #
#  ##########  #  #######  ####  ####  ####  ##########  #  #
#  #  #        #  #  #     #     #        #     #  #        #
#  #  ##########  #  #  ####  #  #  #  ##########  #  #######
#        #     #        #     #  #  #        #  #  #        #
#  ####  ####  #  #  ####  ##########  #######  #  #  #  ####
#  #           #  #     #     #  #                    #     #
#######  #  ####  #######  #  #  ##########  ##########  ####
#        #     #  #  #     #              #  #  #  #  #     #
#######  ##########  #  ####  ####  ####  #  #  #  #  #  ####
#     #           #        #  #     #  #  #     #     #     #
####  #  ####  #  #  ####  #######  #  #  #######  #######  #
#  #  #  #  #  #  #  #  #     #  #  #  #  #           #     #
#  #  #  #  #######  #  #  #  #  #  #  #######  ##########  #
#           #     #  #     #  #           #  #        #     #
#  #######  #  #  #  #  ####  #  #  ####  #  #  ####  ####  #
#        #     #  #  #     #  #  #  #              #  #     
##########################################################  
