   ##########################################################
   #        #           #           #              #  #     #
#  ####  #  #  #  ####  #  ####  #######  #  #######  #  ####
#        #     #     #  #     #        #  #  #  #           #
#######  ####  #  #######  #############  #  #  ####  ####  #
#     #  #     #     #  #     #        #  #  #        #  #  #
####  ####  #  ####  #  #  ####  ##########  ####  ####  #  #
#           #     #        #        #        #           #  #
#  #  #######  #######  ####  ##########  ##########  #######
#  #     #        #           #        #     #           #  #
####  ####  #  ##########  #  #  ####  ####  #  #######  #  #
#     #  #  #        #     #     #  #     #     #           #
#######  #  #  #  #  #######  #  #  #  ##########  #######  #
#           #  #  #  #     #  #  #           #     #        #
####  #######  #  #######  ####  #  ####  ####  ####  #######
#  #     #  #  #     #     #     #     #        #  #  #     #
#  #  ####  #######  #  ###################  ####  #  #  ####
#        #     #           #        #     #  #  #  #  #  #  #
##########  #######  #  #######  ####  #######  #  #  #  #  #
#        #     #     #                    #  #  #     #     #
#  #######  #######  #  #  ####  #  #  ####  #  ####  ####  #
#  #  #  #  #  #     #  #  #     #  #     #        #     #  #
#  #  #  #  #  #  #######  ##########  ####  ####  ####  #  #
#  #  #     #           #  #           #  #  #              #
#  #  ####  ####  ####  #######  #  ####  #######  #  #######
#  #  #     #     #  #  #  #  #  #     #  #     #  #        #
#  #  ####  #  ####  ####  #  ##########  #  #  #  #######  #
#  #  #  #                 #     #           #  #     #  #  #
#  #  #  ####  #######  ####  #  #######  ####  #######  #  #
#     #              #        #     #        #     #  #     #
####  #  ##########  ####  #  ####  ####  #  #  ####  ####  #
#        #  #           #  #     #  #  #  #  #  #  #        #
#  ####  #  #  ####  ##########  #  #  #  #  ####  ####  #  #
#  #     #     #     #     #  #  #  #     #        #  #  #  #
#######  ##########  #  ####  ###################  #  #  #  #
#     #  #     #  #              #              #  #     #  #
#  #######  ####  ####  ####  #  #######  #  #  #  #  #######
#  #           #           #  #     #  #  #  #  #     #  #  #
#  #  #  #  #  #  #######  ####  ####  ####  #######  #  #  #
#     #  #  #           #  #                 #              
##########################################################  
